1111111111
10EP100001
10001CC0X1
1111111111
